apple - яблуко
banana - банан
orange - апельсин
java - джава
programming - програмування
code - код
computer - комп'ютер
mouse - мишка
keyboard - клавіатура
screen - екран
sky - небо
blue - синій
red - червоний
green - зелений
random - випадковий
word - слово
text - текст
file - файл
input - ввід
output - вивід
stream - потік
buffer - буфер
reader - зчитувач
writer - записувач
list - список
set - множина
map - мапа
collection - колекція
interface - інтерфейс
class - клас
object - об'єкт
human - людина
policeman - поліцейський
firefighter - пожежник
vehicle - транспорт
road - дорога
car - машина
bus - автобус
taxi - таксі